########
# 0    #
#      #
#x     #
#      #
#      #
#      #
########
0 = player spawn point
x = gold
z = enemy