#########
# 0     #
#       #
# X     #
#       #
#       #
#       #
#########