########
# 0    #
#      #
# X    #
#      #
#      #
#      #
########